NO ./img/black.png
F 255,000,0
SO ./img/blue.jpeg


WE ./img/red.png
EA                          ./img/white.png


C 225,30,0


        11111111111111111111111111111
111111111011000001110000000000001
100000000011000001110111111111111
11110111111111011100000010001
11110111111111011101010010001
11000000110101011100000010001
10000000000000001100000010001
10000000000000001101010010001
1100000111010101111101111010111
11110111 1110101 101111010001
11111111111111111111111111111
