NO ./black.png
F 255,100,0
SO ./blue.jpeg


WE ./red.png
EA                          ./white.png


C 225,30,0




1111111
 111101
 11 101
11  1001
 111111