NO textures/wall_1.xpm
SO textures/wall_2.xpm


WE textures/wall_3.xpm

EA textures/wall_3.xpm


F 20,100,0

C 247,164,55

        1111111111111111111111111
       1000000000110000000000001
        1011000001110000000000001
        1001000000000000001000001
11111111101100000111000000W1000001
1000000001100000111001111111111111
11110111111011011100000010001
11110111111111011101010010001
111100011010101100000010001111
10000000000000001100000010001
10000000000000011010100100111
11000001110101011101111011111111
11110111 1110101 10111010001
11111111 1111111 111111111111