NO textures/black.png
SO textures/blue.jpeg


WE textures/red.png
EA                          textures/white.png


F 20,100,0

C 225,30,0

        1111111111111111111111111
        100000000011000000S000001
        1011000001110000000000001
        1001000000000000000000001
111111111011000001110000000000001
10000000011000001110011111111111111
11110111111011011100000010001
11110111111111011101010010001
1111000110101001100000010001111
10000000000000001100000010001
10000000000000011010100100111
11000001110101011101111011111111
11110111 1110101 10111010001
11111111 1111111 111111111111