NO img/black.png
SO img/blue.jpeg


WE img/red.png
EA                          img/white.png


F 20,100,0

C 225,30,0

        1111111111111111111111111
        1000000000110000000000001
        1011000001110000000000001
        1001000000000000000000001
1111111110110000011100000000000011111100011
1000000001100000111001111111111
1111011111W011011100000010001
11110111111111011101010010001
11000000110101011100000010001111111111111111
10000000000000001100000010001
100000000000000110101001001
1100000111010101110111101111111101111
11110111 1110101 10111010001
11111111 1111111 111111111111