NO    textures/black.png
SO         textures/blue.jpeg

         
         
WE textures/red.png
EA                          textures/white.png


F 20,10,0


C 225,30,0


        1111111111111111111111111
        1000000000110000000000001
        1011000001110000000000001
        1001000000000000000000001
111111111011000001110000000000001
10000000011000001110111111111111
1111011111W111011100000010001
11110111111111011101010010001
1100000011010101110000001000111111111111111111111
10000000000000001100000010001
1000000000000001101010010001
110000011101010110111101111
11110111 1110101 10111010001
11111111 1111111 111111111111
