NO textures/wall_1.xpm
SO textures/wall_2.xpm


WE textures/wall_3.xpm
EA                          textures/wall_4.xpm


F 20,100,0

C 247,164,51

        1111111111111111111111111
        1000000000110000000000001
        1011000001110000000000001
        1001000000000000000000001
11111111101100000111000000N000001
100000000110000011100111111111111
11110111111011011100000010001
11110111111111011101010010001
1111000110101001100000010001111
10000000000000001100000010001
10000000000000011010100100111
11000001110101011101111011111111
11110111 1110101 10111010001
11111111 1111111 111111111111