NO textures/wall_1.xpm
SO textures/wall_2.xpm


WE textures/wall_3.xpm
EA                          textures/wall_4.xpm


F 20,100,0

C 247,164,51

        1111111111111111111111111
        1000000000110000000000001
        1011000001110000000000001
        1001000000000000000000001
111111111011000001110000000000001111111
100000000110000011100111111111111
1111011111S011011100000010001
11110111111111011101010010001
11000000110101011100000010001111111111111111
10000000000000001100000010001
10000000000000011010100100111
110000011101010111011110111111111111
11110111 1110101 10111010001
11111111 1111111 111111111111