NO textures/black.png
SO textures/blue.jpeg


WE textures/red.png
EA                          textures/white.png


F 20,100,0

C 225,30,0

        11111111111111111111111111
        11000000000110000000000001
        11001000000000000000000001
1111111111110000011100000000000011
1000000000110000011101111111111111
1100000000000000000000000000000001
110000000000000N000000000000000001
1100000000000000000000000000000001
1111011111111101110000001000111111
111111111111111111111111111111    