NO textures/black.png
SO textures/blue.jpeg


WE textures/red.png
EA                          textures/white.png


F 20,100,0

C 225,30,0

11111111
10100001
10100001
10100001
10000101
100E0001
10000001
11111111
