NO ./img/black.png
F 255,000,0
SO ./img/blue.jpeg


WE              ./img/red.png
EA                          ./img/white.png


C                125,30,0


11111111
 10100001
 10100001
 10100001
 10000001
 1000E101
 10000001
 11111111
