NO ./img/black.png
F 255,000,0
SO ./img/blue.jpeg


WE              ./img/red.png
EA                          ./img/white.png


C                125,30,0


111111111111111111111111
100000000000000000000000111111
1011111111111111111111101
1000000000000000000000001
1000111111111101111110001
1000100000000101000010001
1000100000000101000010001
1011100000000101111011101
1000000000000000000000001
1000111111111101111110001
1000100000000101000N10001
1000100000000101000010001
1111111111111111111111111
