NO textures/wall_1.xpm
SO textures/wall_2.xpm


WE textures/wall_3.xpm
EA                          textures/wall_4.xpm


F 247,164,51

C 43,154,175

        11111111111111111111111111
        11000000000110000000000001
        11001000000000000000000001
1111111111110000011100000000000011
1000000000110000011101111111111111
1100000000000000000000000000000001
110000000000000E000000000000000001
1100000000000000000000000000000001
1111011111111101110000001000111111
111111111111111111111111111111    