NO textures/wall_1.xpm
SO textures/wall_2.xpm


WE textures/wall_3.xpm

EA textures/wall_4.xpm

F 20,100,0

C 247,164,55

11111
111001
11N001
111111